BBBBBBBBBBBBBBBBBBBBB
B###################B
B###################B
B#################C#B
B#############GGGGG#B
B###################B
BP####C#############B
BGGGGGGGGGGGGGGGGGGGB