GGGGGGGGGGGGGGGGGGGGGG
G####################G
G####################G
G####################G
G####################G
GGGG#####GGGG#####GGGG
G####################G
G####################G
GGGGGG####P#####GGGGGG
G####################G
G###########G########G
GGGGGGGGGGGGGGGGGGGGGG