BBBBBBBBBBBBBBBBBBBBB
B###################B
B###################B
B##C##########S###C#B
BGGGG#########GGGGG#B
B###################B
BP####C#############B
BGGGGGGGGGGGGGGGGGGGB