BBBBBBBBBBBBBBBBBBBBB
B###################B
B###################B
B###################B
B###################B
B###################B
BE#################PB
BGGGGGGGGGGGGGGGGGGGB