GGGGGGGGGGGGGGGGGGGGGG
G####################G
G####################G
G##################EGG
G##################G#G
G#####P###########G##G
G#####G#########EG###G
G######G########G####G
G#######GE#####G#####G
G########G####G######G
G#########G##G#######G
GGGGGGGGGGGGGGGGGGGGGG