G###################G
G###################G
G###################G
G###################G
G###################G
G###################G
G###################G
G###############P###G
G##########GGGGGG###G
G#########G#########G
G########G##########G
G#######G###########G
GE#####G############G
GGGGGGGGGGGGGGGGGGGGG