BBBBBBBBBBBBBBBBBBBBB
B###################B
B###################B
B###################B
B###################B
B###################B
BE#########P########B
GGGGGGGGGGGGGGGGGGGGG