GGGGGGGGGGGGGGGGGGGGGG
G####################G
G####################G
G####################G
G####################G
GGGG#####GGGG#####GGGG
G########P###########G
G####################G
GGGGGG##########GGGGGG
G####################G
G####################G
GGGGGGGGGGGGGGGGGGGGGG