####################
GGG#####GGGG#####GGG
########P###########
####################
GGGGG##########GGGGG
####################
####################
GGGGGGGGGGGGGGGGGGGG