BBBBBBBBBBBBBBBBBBBBBBBBBBBBBBBBBBBBBBBB
B######################################B
B######################################B
B######################################B
B######################################B
B######################################B
B######################################B
B######################################B
B######################################B
B######################################B
B###############P######################B
B#############GGG######################B
B############G#########################B
B###########G##########################B
BE#########G###########################B
BGGGGGGGGGGGGGGGGGGGGGGGGGGGGGGGGGGGGGGB