BBBBBBBBBBBBBBBBBBBBB
B###################B
B###################B
B###################B
B#############G##GG#B
B############G######B
BE#########PG#######B
GGGGGGGGGGGGGGGGGGGGG