BBBBBBBBBBBBBBBBBBBBB
B###################B
B###################B
B###################B
B################GG#B
B############G######B
B##E########G####P##B
BGGGGGGGGGGGGGGGGGGGB