BBBBBBBBBBBBBBBBBBBBB
B###################B
B###################B
B##################PB
B################GG#B
B############G######B
B###########G#######B
BGGGGGGGGGGGGGGGGGGGB