BBBBBBBBBBBBBBBBBBBBB
B###################B
B###################B
B###################B
B##################PB
B#############GGGGGGB
B###################B
B###################B
B######E############B
B###################B
B###################B
B###################B
B###################B
B###################B
BGGGGGGGGGGGGGGGGGGGB