BBBBBBBBBBBBBBBBBBBBB
B###################B
B###################B
B###################B
B################GG#B
B############G######B
B###P#######G#######B
BGGGGGGGGGGGGGGGGGGGB