BBBBBBBBBBBBBBBBBBBBB
B###################B
B###################B
B###################B
B###################B
B###################B
B##########P########B
B########GGGGGG####GB
B#######G###########B
B######G#######E####B
BGGGGGGGGGGGGGGGGGGGB