BBBBBBBBBBBBBBBBBBBBB
B###################B
B###################B
B#############C###P#B
B#############GGGGG#B
B###########CG######B
B#####C#####G#######B
BGGGGGGGGGGGGGGGGGGGB