BBBBBBBBBBBBBBBBBBBBBBBBBBBBBBBBBBBBBBBBBB
B########################################B
B########################################B
B########################################B
B################GG######################B
B############G###########################B
BC#S########G##########################P#B
BGGGGGGGGGGGGGGGGGGGGGGGGGGGGGGGGGGGGGGGGB