BBBBBBBBBBBBBBBBBBBBBBBBBBBBBBBBBBBBBBBBBB
B###################BB###################B
B###################BB###################B
B################E##BB###################B
B################GG#BB###################B
B############G######BB###################B
B##E#####E##G#######BB#################P#B
BGGGGGGGGGGGGGGGGGGGBBGGGGGGGGGGGGGGGGGGGB